%%%%%%
%. G.%
%.   %
%    %
%P  .%
%%%%%%
