%%%%%%
%.  G%
%    %
%    %
%P  o%
%%%%%%
